11 11
WWWWWWWWWWW
WWWWW00GWWW
WcWWW0WWWWW
W0WWW0WWWWW
W000BCWWWWW
WWWW0A000WW
WWW00WWW0WW
WWWS0WWWbWW
WWWW0WWWWWW
WWa00WWWWWW
WWWWWWWWWWW