13 16
WWWWWWWWWWWWW
WWWW0dWW0WWWW
W00W0WWW0D0WW
WW0W0WGWaW0WW
WW000W0WWW0WW
WWW0WWAWWW0WW
WWW0Wb00WW0WW
WWW0C0S0B00WW
WWW0W000WW0WW
WWW0WWWWW00WW
W00000WWW0Wc0
W0WWW0W0W0WW0
W0WWW000W0000
W00WWWW0WWWWW
WWWWWWW00WWWW
WWWWWWWWWWWWW